                  +--+--+--+--+
                  |        |  |
+--+--+  +--+--+  +  +--+  +  +
|                             |
|                             |
|                             |
+--+--+  +--+--+  +  +--+  +  +
      |  |
      +  +-------------------------------+
      |                                   
+--+--+----------------------------------+